1111111111111111111111111111111111111111
1=======================================
1=11111111111111111111111111111111111111
1=1-----------------------------------91
1=1-111111111111111111111111111111111111
1=1-1TAAAAAAAAAAAAAAAAAA-1-1DDDDDDDDDDDD
1=1-1T111111111111111111-1-1DDDDDDDDDDDD
1=1-1T1==========1OOOOO1---1DDDDDDDDDDDD
1=1-1T#O=========~OOOOO1---1DDDDDDDDDDDD
1=1-1T#O=========~OOOOO111-1DDDDDDDDDDDD
1=1-1T1OOO688OOOO1OOOOOOO1-1DDDDDDDDDDDD
1=1-1=1OKKK88KKKO1OOOOOOO1=1DDDDDDDDDDDD
1=1-1=1OOOO88OOOO1OOOOOOO#=1DDDDDDDDDDDD
1=1-1=1OKKK88KKKO1OOOOOOO111DDD1OOO1DDDD
1=1-1=1OOOO88OOOO1OOO6OOO1DDDD_~OOO1DDDD
1=1-1=1OKKK88KKKO1OOOOOOO1=DDD_1OOO1DDDD
1=1-1-1OOOO88OOOO1OOOOOOO~EDDD_1DDDDDDDD
1=1-1-1OKKK88KKKO111111111=DDD_1DDDDDDDD
1=I---IOOOO886OOOIDDDDDDDDDDDD_1DDDDDDDD
1=I---IOKKK88KKKOIDDDDDDDDDDDD_1DDDDDDDD
1=I---IOOOO88OOOOIDDDDDDDDDDDD_1DDDDDDDD
1#IDDII1111~~1111IDDI1111111DDDDDDDDDDDD
1__\/____(1~~1)___\/_1------DDDDDDDDDDDD
1_____DD_____________1------DDDDDDDDDDDD
1_DDDDDDD______5DDDD_1------DDDDDDDDDDDD
1_DDDDDDDDDDDDDDDDDD_I111111111DDDDDDDDD
1_DDDDDDDDDDDDDDDDDD_IDDD191DD1DDDDDDDDD
1_DDDDDDDDDDDDDDDDDD_ID1D1D1DD1DDDDDDDDD
1_DDDDDDDDDDDDDDDDDD_ID1D1D1TDADDDDDDDDD
1_DDDDDDDD____DDDDDD_ID1D1D1TD1DDDDDDDDD
1_DDDDDDDD_ZS_DDDDDD_ID1D1D1TD1DDDDDDDDD
1_DDDDDDDD_SZ_DDDDDD_ID1D1#1TD1DDDDDDDDD
#_DDDDDDDD____DDDDDD_I9111TTTD1DDDDDDDDD
#_DDDDDDDDDDDDDDDDDD_I1111#1111DDDDDDDDD
1_4DDDDDDDDDDDDDDDDD_1---------DDDDDDDDD
1____________________1---------DDDDDDDDD
1111111111111111111111111111111111111111
DDDDDDDDDDDDDDDDDDDDDDDDDDDDDDDDDDDDDDDD
DDDDDDDDDDDDDDDDDDDDDDDDDDDDDDDDDDDDDDDD
DDDDDDDDDDDDDDDDDDDDDDDDDDDDDDDDDDDDDDDD
