0000000000000000011HHHH10000000000000000
111111111111111111119=-11111111111111111
RRRRRRRRRRRRRRRRRRRR#1111111111111111111
R0000000000000000001O1AOOOOOOOOOOOOOOO\1
R1RRRRRRRRRRRRRRRRRR#1AOOOOOOOOOOOOOOOO1
R1R11111111111111111~11111\OOOOO6OOOOOO1
R1T@/OOOOOOOOOOO1OOOOOOOOO1OOOOOOOOOOOO1
R1O1OO5OOOO6OOOO1OOOOOOOOO~OOLLLLLLLLLL1
R1OOOOOOOOOOOOOO~OOODDDOOO11111A11111111
R1OOOOOOLKOOKLOO1OOODDDOOO1_000000001#11
RRR11111111111111OOODDDOOO\1000000000001
RT@/OOOOOOOOOOOO1OOODDDOOOO#000000000001
RO1OOO6OOOO6OOOO1OOODDDOOO/1000000000001
ROOOOOOOOOOOOOOO1OOODDDOOO1_000000000001
ROOOOOOOOOOOOOOO~OOOOOOOOO11111A10000001
ROOOOOOOLKOOKLOO1OOOOOOOOO~OOOOO10000001
R1111111111111111OOOOOOOOO1OOOOO10000001
R0000000000011111111111111/OOOOO10000001
R000000000001OOOOOOOOOOO1OOOOOOO10000001
R000000000001OOOOOOOOOOO~OOODDOO10000001
R0000000000011111111111A1\OODDOO10000001
R0000000000000000000000001OODDOO10000001
R000000000000000000000000AOODDOO10000001
R0000000000000000000000001OODDOO10000001
R1111111111111111111111A1/OODDOO10000001
ROOOLKOLKOOOOOOOOOOOOOOO~OOOOOOO10000001
ROOOOKOOKOOOOOOOOOOOOOO/1\OOOOO/11111111
R\OOOOOOOOOOOOO6OOOOOOO111OOOOO1OOOOOOO1
RR#11111111111111111111111OOOOO~OODDDOO1
1/OOOOOOO1OOOOOOOOOOOOO\1/OOOOO1OODDDOO1
1O+O+OO+O1OODDDDDDDDDOOO~OOOOOO1OOO6OKK1
1OOOOOOOO1OOOOOOOOOOOOO/1\OOOOO1OOOOLKK1
1111111111111111~11111111111111111111111
1000888888888000____________|00000000000
100888888888880088888880000_|00000000000
111111111111110884___080000_|00000000000
000000000000010081_1________|00000000000
000000000000011111#111111111100000000000
II000000000000000___00000000000000000000
II0000000000000OOOOOO0000000000000000000