IIII#IIIIIIIIIIIIIIIIIIIIIIIIIIIIIIIIIII
I_____IDDD000DDDDDD0000000000000DD00000I
1_000_10---0-0---DD___00---0---0DDD0000I
I_00D_1000D000DDDDD___00000000DDDDDDD00I
I_DDD_1___________________________0---0I
#40DD_~___________________________00000I
I_00D_1___________________________0---0I
I_000_100IIIIIIAAI0__000000000____00000I
1_____100I9I1UOOOO-__0-0-0-0-0____0---0I
111111100I9=LUOOOO-__0-0-0-0-0____00000I
100DDD005IIIIIIAAI0__0-0-0-0-0____0---0I
100DDDD000000000000__111111111____00000I
10-0______________________________0---0I
10-0______________________________00000I
10-0______________________________0---0I
1000____100000000000000000000000000DDD0I
10-0____1---00-0-00-0-0-001I1I1I1I06DDDI
10-0____10D000-0-00-0-0-00I=X99991000DDI
10-0____1---00-0-00-0-0-001#1I1I1I00DDDI
1000____1000000000000000000_000000DDD00I
10-0______________________________00000I
10-0______________________________0---0I
10-00000__________________________00000I
11111110________A_________________0---0I
%VVVVV100DDD00IIAIIIIIIII__0000000000DDI
%VVVVV100DDDD0I====PPPPPI__000000000DDDI
%VVVVV1000DDD0I====P9HHHI__0050000DDDDDI
VVVVVV100500D0I====P9PPPY__000000000DDDI
VVVVVV10DD0000I====1=1==#__00000000600DI
VVVVVV100D0000I=T1J=====R__000000000000I
%VVVVV1KKKKKKKIXRRRRRRRRRKKKKKKKKKKKKKKI
%\VVVVVVVVVVVVVVVVVVVVVVVVVVVVVVVVVVVVV%
%/VVVVVVVVVVVVVVVVVVVVVVVVVVVVVVVVVVVVV%
%VVVVVVVVVVVVVVVVVVVVVVVVVVVVVVVVVVVVVV%
%VVVVVVVVVVVVVVVVVVVVVVVVVVVVVVVVVVVVVV%
%VVVVVVVVVVVVVVVVVSZVVVVVVVVVVVVVVVVVVV%
%VVVVVVVVVVVVVVVVVVVVVVVVVVVVVVVVVVVVVV%
%\VVVVVVVVVVVVVVVVVVVVVVVVVVVVVVVVVVVVV%
%/VVVVVVVVVVVVVVVVVVVVVVVVVVVVVVVVVVVVV%
%%%%%%%%%%%%%%%%%%%%%%%%%%%%%%%%%%%%%%%%
