LLLLLLLLLLLLLLLLLLLLLLLLLLLLLLLLLLLLLLLL
LLLLLLLLLLLLLLLLLLLLLLLLLLLLLLLLLLLLLLLL
LLLLLLLLLLLLLLLLLLLLLLLLLLLLLLLLLLLLLLLL
LLLLLLLLLLLLLLLLLLLLLLVVVVVVVVVVVVVVVVVV
LLLLLLLLLLLLLLLLLLLLVVVVVVVVVVVVVVVVVVVV
LLLLLLLLLLLLLLLLLLLVVVVVVVVVVVVVVVVVVVVV
LLLLLLLLLLLLLLLLLLVVVIIIIAIIIIVVVVVVVVVV
LLLLLLLLLLLLLLLLLLVVVI/=====\IVVVVVVVVKK
LLLLLLLLLLLLLLLLLVVVVIK=*****IIIIIIIIIIK
LLLLLLLLLLLVVVVVVVVVVYKv*****!=======!=K
LLLLLLLLLVVVVVVVVVVVVIK=*****IIIIII#II!K
LLLLLLLVVVVVVVVVVVVRRR\=====/IVVI****#=L
LLLLVVVVVVVVVVVVVVVR@TIIIAIIIIVVIK***#=L
VVVVVVVVVVVVVVVVVVVRRVVVVVVVVVVVIK***#=L
RRRRRRRRRRRRRRRRRRRRRAIIIIVVVVVVIK***#=L
R========================IVVVVVVIK***#=L
R-=======================IVVVVVVI****#=L
R#111111111111131111111111111A11111#11=K
1-1============**********************1!K
1=1=====================---**********!=K
1=1=1RRRRRRRRRRRRRRRRRRRR#RRRRRRRRRRRRRR
1=1=1TAAAAAAAAAAAAAAAAAA=--11111111DRDDD
1=1=1R11111YY11111111111y4-#===1DDDDRDDD
1=1=1-#-*********1OOOOO1===111=1DDDDRDDD
1=1=1-#6-*******-~OOOOO1===1D1=1DDDDRDDD
1=1=1-#O---------~OOOOO111=1DRRRRRRRRDDD
1=1=1=1OOOO88OOOO1OOOOOOO1=1DRDDDDDDDDDD
1=1=1=1OKKK88KKKO1OOOOOOO1=1DRDDDDDDDDDD
1=1=1=1OOOO88OOOO1OOOOOO6#=1DRDDDDDDDDDD
1=1=1=1OKKK88KKKO1OOOOOOO111RRD1OOO1DDDD
1=1=1=1OOOO88OOOO1OOOOOOO1DDDD_~OOO1DDDD
1=1=1=1OKKK88KKKO1OOOOOOO1=DDD_1OOO1DDDD
1=1=1=1OOOO88OOOO1OOOOOOO#=DDD_1DDDDDDDD
1=1=1=1OKKK88KKKO111111111=DDD_1DDDDDDDD
1=I===IOOOO886OOOIDDDDDDDDDDDD_1DDDDDDDD
1=I===IOKKK88KKKOIDDDDDDDDDDDD_1DDDDDDDD
19IKKKIOOOO88OOOOIDDDDDDDDDDDD_1DDDDDDDD
1~IIIII1111##1111IDDI1111111DDDDDDDDDDDD
IVVVVVVVVVVVVVVVVVVVVVVVVVVVVVVVVVVVVVVV
IVVVVVVVVVVVVVVVVVVVVVVVVVVVVVVVVVVVVVVV
