11111111111111111111
1*201060050005000111
1340~000000600070191
10001111100111111101
1111100011007000100|
10000000001010015711
1700070011X100107711
100000000~0000117711
10001110011111001001
11~10101001101100101
110110110111011X0001
10001110111~011X6011
1000000001111XXX0011
1111111X000110000011
190010911~11011~1111
1000|001000100005001
10001001000\111|0001
1000|001000000110701
1000700#060000000001
111111111111111111#1
