111111111111111|1111
10001060000000000091
#0050000000000070001
11111X11|~~11111X111
15000000~00000000011
160000001000000700|1
170007001700100000#0
10000000|000|00500|1
#0000700100710000011
11111X1110|111110011
111111111~1111|10011
100010700000000#0011
#000~000000011110011
1|11X111000110000011
#0000001111100111111
10000001000100000001
11107011000|1111000#
12300051000000110701
1*40005~0000000~0001
11##1111111111111111
