11111111111111111111
100700000~0000119111
#0000600010000070111
11~11100010070000111
10000111110000070|11
#0000000010000000111
10000500011111111111
1070|600000000000111
10000000000000000111
11111X11111X11060111
1111111|111111000|11
107010000~0100000111
#000~005010100500111
11111000010100000111
10010011110160XXX111
1001000001010000000#
#00|1110010111|11001
100000000X0000000001
100000000100000234*1
11111111111111111111
