1111111|111111111111
190010000~0050111111
|0701000015000~00111
111~10500100001\0111
1000\~11110050110111
100000000100001|0111
|000070001~111110111
10050000016000110111
#0000000/10000110|11
11111111111111110111
111111|11111|1110111
106010000~00501|0111
#000~0000100001/0111
11X11000010500~00111
100000X1110000111111
10000000\1\5000~0001
140000000111111\000#
1\00000501/0000|0001
1*0000000100000#0501
11#11111110000011111
