11111111111111111111
10000000000000000001
10000000000000000001
10000000000000000001
10000000000000000001
10000000000000000001
10000000000000000001
10000000000000000001
10000000000000000001
10000000000000000001
10000000000000000001
10000011110000000001
10000000000000000001
10000000000000000001
10000000000000000001
10000000000000000001
1_40==00_11__%##|__1
10000000000000000001
10000000000000000001
1111##11111111\00001
