0000000000000000000000000000000000000000
0000000000000000000000000000000000000000
0000000000000000000000000000000000000000
0000000000000000000000000000000000000000
0000000000000000000000000000000000000000
0000000000000000000000000000000000000000
0000000000000000000000000000000000000000
0000000000000000000000000000000000000000
0000000000000000000000011A11000000000000
0000000000000000000000/*****\00000000000
0000000000000000000001*******11111111111
0000000000000000000001v****************1
0000000000000000000001*******111111111*1
0000000000000000000000\*****/--------1*1
0000000000000000000000011A110--------1*1
00000000000000000000000000000--------1*1
00000000000000000000000000000--------1*1
11111111111111111111111111111111111111*1
19===================================1*1
1=111111111111111111111111111113111111*1
1=1----------------------------********1
1=1----------------------------********1
1=1-1111111RRRRRRRRRRRRRRRRRRRRRRRRRRRRR
1=1-1TAAAAAAAAAAAAAAAAAA-1-1000000000000
1=1-1T111111111111111111-1-1000000000000
1=1-1T1=====6====1=====1---1000000000000
1=1-1T#================1---1000000000000
1=1-1=#================111-1000000000000
1=1-1=1OOOO88OOOO1=======1-1000000000000
1=1-1=1OKKK88KKKO1=======1=1000000000000
1=1-1=1OOOO88OOOO1=========1000000000000
1=1-1=1OKKK88KKKO1======1111000000000000
1=1-1=1OOOO88OOOO1===6==1000000000000000
1=1-1=1OKKK88KKKO1======1000000000000000
1=1-1-1OOOO88OOOO1======9000000000000000
1=1-1-1OKKK88KKKO11111111001000000000000
1=I---IOOOO88OOOOI0000000001000000000000
1=I---IOKKK88KKKOI0000000001000000000000
1=I---IOOOO88OOOOI0000000001000000000000
1#I00II1111~~1111I00I1111111000000000000
