0000000000000000000000000000000000000000
0000000000000000000000000000000000000000
0000000000000000000000000000000000000000
0000000000000000000000000000000000000000
0000000000000000000000000000000000000000
0000000000000000000000000000000000000000
0000000000000000000000000000000000000000
0000000000000000000000000000000000000000
0000000000000000000000011A11000000000000
0000000000000000000000/*****\00000000000
0000000000000000000001*******11111111111
0000000000000000000001v****************1
0000000000000000000001*******111111111*1
0000000000000000000000\*****/--------1*1
0000000000000000000000011A110--------1*1
00000000000000000000000000000--------1*1
00000000000000000000000000000--------1*1
11111111111111111111111111111111111111*1
19===================================1*1
1=111111111111111111111111111113111111*1
1=1----------------------------********1
1=1----------------------------********1
1=1-1111111RRRRRRRRRRRRRRRRRRRRRRRRRRRRR
1=1-1======TAAAAAAAAAAAAAAAAAAAAAAAA-1#R
1=1-1======RR11111111111111111111111-14R
1=1-1=======R========6=======1=====1---R
1=1-1=======#======================1---R
1=1-1=======#======================111-R
1=1-1=======1================1=======1-R
1=1-1=======1=KKKKK=====KKKK=1=======1#R
1=1-1=1=====1================1=========1
1=1-1=1=====1=KKKKK=====KKKK=1=========1
1=1-1=1=====1================1=====6===1
1=1-1=1=====1=KKKKK=====KKKK=1=========1
1=1-1-1=====1================1=========9
1=1-1-1=====1=KKKKK=====KKKK=1=====11111
1=1---1=====1================1=====10000
1=1---1=====1=KKKKK=====KKKK=1=====10000
1=1---1=====1================1=====10000
1#11111111111111111#####1111111111111111
