1111111111111111111111111111111111111111
1=======================================
1=11111111111111111111111111111111111111
1=1------------------------------------1
1=1------------------------------------1
1=1-111111111111111111111111111111111111
1=1-1=======A----------------A-----A-1-1
1=1-1=======1****************1=====1-1-1
1=1-1=======1****************1=====1---1
1=1-1=======#****************#=====1---1
1=1-1=======#****************#=====111-1
1=1-1=======1****************1=======1-1
1=1-1=======1*KKKKK*****KKKK*1=======1=1
1=1-1=1=====1****************1=========1
1=1-1=1=====1*KKKKK*****KKKK*1=========1
1=1-1=1=====1****************1=========1
1=1-1=1=====1*KKKKK*****KKKK*1=========1
1=1-1-1=====1****************1=========#
1=1-1-1=====1*KKKKK*****KKKK*1=====11111
1=1---1=====1****************1=====10000
1=1---1=====1*KKKKK*****KKKK*1=====10000
1=1---1=====1****************1=====10000
1#11111111111111111~~~~~1111111111111111
1400000000000000000=====0000#-----------
1000000000000000000=====0000#-----------
1000000000000000000=====0000#-----------
1000000000000000000000000000#-----------
10000000000000000000000000001111111111--
1000000000000000000000000000A000101001--
10000000000000000000000000001010101001--
1000000000000000000000000000101010100A--
100000000000____0000000000001010101001--
100000000000_/\_0000000000001010101001--
#00000000000_\/_00000000000010101#1001--
#00000000000____0000000000001011100001--
#00000000000000000000000000011111#1111--
#000000000000000000000000000#-----------
10000000000000e0000000000000#-----------
1000000000000000000000000000#-----------
1111111111111111111111111111111111111111
