1111111111111111111111111111111111111111
1=======================================
1=11111111111111111111111111111111111111
1=1-----------------------------------91
1=1-111111111111111111111111111111111111
1=1-1TAAAAAAAAAAAAAAAAAA-1-1000000000000
1=1-1T111111111111111111-1-1000000000000
1=1-1T1==========1OOOOO1---1000000000000
1=1-1T#O=========~OOOOO1---1000000000000
1=1-1=#O=========~OOOOO111-1000000000000
1=1-1=1OOO688OOOO1OOOOOOO1-1000000000000
1=1-1=1OKKK88KKKO1OOOOOOO1=1000000000000
1=1-1=1OOOO88OOOO1OOOOOOOO=1000000000000
1=1-1=1OKKK88KKKO1OOOOOOO1110001OOO10000
1=1-1=1OOOO88OOOO1OOO6OOO10000_~OOO10000
1=1-1=1OKKK88KKKO1OOOOOOO1=000_1OOO10000
1=1-1-1OOOO88OOOO1OOOOOOO~E000_100000000
1=1-1-1OKKK88KKKO111111111=000_100000000
1=I---IOOOO88OOOOI000000000000_100000000
1=I---IOKKK88KKKOI000000000000_100000000
1=I---IOOOO88OOOOI000000000000_100000000
1#I00II1111~~1111I00I1111111000000000000
1__\/____(1~~1)___\/_1------000000000000
1_____00_____________1------000000000000
1_0000000______00000_1------000000000000
1_000500000006000000_I111111111000000000
1_000000000000000000_I000191001000000000
1_000000000000000000_I010101001000000000
1_000000000000000000_I010101T0A000000000
1_00000000____000000_I010101T01000000000
1_00000000_}{_000000_I010101T01000000000
1_00000000_{}_000000_I0101#1T01000000000
#_00000000____000000_I9111TTT01000000000
#_000000000000000000_I1111#1111000000000
1_400000000000000000_1---------000000000
1____________________1---------000000000
1111111111111111111111111111111111111111
0000000000000000000000000000000000000000
0000000000000000000000000000000000000000
0000000000000000000000000000000000000000
