0000000000000000011111110000000000000000
111111111111111111119O111111111111111111
RRRRRRRRRRRRRRRRRRRR#1111111111111111111
R0000000000000000001O1OOOOOOOOOOOOOOOO\1
R1RRRRRRRRRRRRRRRRRR#1OOOOOOOOOOOOOOOOO1
R1R11111111111111111~11111\OOOOO6OOOOOO1
R@T@/OOOOOOOOOOO1OOOOOOOOO1OOOOOOOOOOOO1
R1O1OO5OOOO6OOOO1OOOOOOOOO~OOOOOOOOOOOO1
R1OOOOOOOOOOOOOO~OOOOOOOOO11111111111111
R1OOOOOOOOOOOOOO1OOOOOOOOO1_000000001#11
R1111111111111111OOOOOOOOO\1000000000001
RT@/OOOOOOOOOOOO1OOOOOOOOOO#000000000001
1O1OOO6OOOO6OOOO1OOOOOOOOO/1000000000001
1OOOOOOOOOOOOOOO1OOOOOOOOO1_000000000001
1OOOOOOOOOOOOOOO~OOOOOOOOO11111110000001
1OOOOOOOOOOOOOOO1OOOOOOOOO~OOOOO10000001
11111111111111111OOOOOOOOO1OOOOO10000001
10000000000011111111111111/OOOOO10000001
1000000000001OOOOOOOOOOO1OOOOOOO10000001
1000000000001OOOOOOOOOOO~OOOOOOO10000001
10000000000011111111111A1\OOOOOO10000001
10000000000000000000000001OOOOOO10000001
1000000000000000000000000AOOOOOO10000001
10000000000000000000000001OOOOOO10000001
11111111111111111111111A1/OOOOOO10000001
1OOOOOOOOOOOOOOOOOOOOOOO~OOOOOOO10000001
1OOOOOOOOOOOOOOOOOOOOOO/1\OOOOO/11111111
1OOOOOOOOOOOOOO6OOOOOOO111OOOOO1OOOOOOO1
11111111111111111111111111OOOOO~OOOOOOO1
1OOOOOOOO1OOOOOOOOOOOOO\1/OOOOO1OOOOOOO1
1OOOOOOOO1OOOOOOOOOOOOOO~OOOOOO1OOO6OOO1
1OOOOOOOO1OOOOOOOOOOOOO/1\OOOOO1OOOOOOO1
1111111111111111~11111111111111111111111
1000000000000000____________#00000000000
100000000000000000000000000_#00000000000
111111111111110004000000000_#00000000000
000000000000010000__________#00000000000
000000000000011111#111111111100000000000
II000000000000000___00000000000000000000
II0000000000000OOOOOO0000000000000000000