1111111111111111111191111111111111111111
RRRRRRRRRRRRRRRRRRRR#1111111111111111111
R000000000000000000101OOOOOOOOOOOOOOOOO1
R1RRRRRRRRRRRRRRRRRR#1OOOOOOOOOOOOOOOOO1
R1R11111111111111111~111111OOOOO6OOOOOO1
R1TOOOOOOOOOOOOO1OOOOOOOOO1OOOOOOOOOOOO1
R1OOOO5OOOO6OOOO1OOOOOOOOO~OOOOOOOOOOOO1
R1OOOOOOOOOOOOOO~OOOOOOOOO11111111111111
R1OOOOOOOOOOOOOO1OOOOOOOOO10000000000001
R1111111111111111OOOOOOOOO10000000000001
RTOOOOOOOOOOOOOO1OOOOOOOOO#0000000000001
1OOOOO6OOOO6OOOO1OOOOOOOOO10000000000001
1OOOOOOOOOOOOOOO1OOOOOOOOO10000000000001
1OOOOOOOOOOOOOOO~OOOOOOOOO11111110000001
1OOOOOOOOOOOOOOO1OOOOOOOOOOOOOOO10000001
11111111111111111111111111OOOOOO10000001
1OOOOOOOOOOOOOOOOOOOOOOOOOOOOOOO10000001
1OOOOOOOOOOOOOOOOOOOOOOOOOOOOOOO10000001
1OOOOOOOOOOOOOOOOOOOOOOOOOOOOOOO10000001
11111111111111111111111A11OOOOOO10000001
10000000000000000000000001OOOOOO10000001
1000000000000000000000000AOOOOOO10000001
10000000000000000000000001OOOOOO10000001
11111111111111111111111A11OOOOOO10000001
1OOOOOOOOOOOOOOOOOOOOOOOO~OOOOOO10000001
1OOOOOOOOOOOOOOOOOOOOOOOO1OOOOO111111111
1OOOOOOOOOOOOOO6OOOOOOOOO1OOOOO~OOOOOOO1
11111111111111111111111111OOOOO1OOOOOOO1
1OOOOOOOOOOOOOOOOOOOOOOOOOOOOOO1OOOOOOO1
1OOOOOOOOOOOOOOOOOOOOOOOOOOOOOO1OOO6OOO1
1OOOOOOOOOOOOOOOOOOOOOOOOOOOOOO1OOOOOOO1
1111111111111111~11111111111111111111111
100000000000000___000000000000000000000#
100000000000000000000000000000000000000#
111111111111110004000000000000000000000#
00000000000001000___0000000000000000000#
000000000000011111#111111111111111111111
II000000000000000___00000000000000000000
II0000000000000OOOOOO0000000000000000000
II00000000000111111111IIIIIIIIIIIIIIIIII
