IIII#IIIIIIIIIIIIIIIIIIIIIIIIIIIIIIIIIII
I_____I00000000000000000000000000000000I
1_000_10---0-0---00___00---0---00000000I
I_000_1000000000000___00000000000000000I
I_000_1___________________________0---0I
#4000_~___________________________00000I
I_000_1___________________________0---0I
I_000_1000IIIIIAAI0__000000000____00000I
1_____1000I9I1OOOO-__0-0-0-0-0____0---0I
1111111000I9=LOOOO-__0-0-0-0-0____00000I
1000000050IIIIIAAI0__0-0-0-0-0____0---0I
1000000000000000000__111111111____00000I
10-0______________________________0---0I
10-0______________________________00000I
10-0______________________________0---0I
1000____1000000000000000000000000000000I
10-0____1---00-0-00-0-0-001I1I1I1I06000I
10-0____1---00-0-00-0-0-00I=99999100000I
10-0____1---00-0-00-0-0-001#1I1I1I00000I
1000____1000000000000000000_00000000000I
10-0______________________________00000I
10-0______________________________0---0I
10-00000__________________________00000I
11111110________A_________________0---0I
%VVVVV10000000IIAIIIIII__00000000000000I
%VVVVV10000000I=O%%%%%I__00000000000000I
%VVVVV10000000I==%9HHHI__00005000000000I
VVVVVV10050000I==%9%%%I__00000000000000I
VVVVVV10000000I==1=1=##__00000000006000I
VVVVVV10000000I=TJ===RI__00000000000000I
%VVVVV1KKKKKKKI1RRRRRRIKKKKKKKKKKKKKKKKI
%\VVVVVVVVVVVVVVVVVVVVVVVVVVVVVVVVVVVVV%
%/VVVVVVVVVVVVVVVVVVVVVVVVVVVVVVVVVVVVV%
%VVVVVVVVVVVVVVVVVVVVVVVVVVVVVVVVVVVVVV%
%VVVVVVVVVVVVVVVVVVVVVVVVVVVVVVVVVVVVVV%
%VVVVVVVVVVVVVVVVVVVVVVVVVVVVVVVVVVVVVV%
%VVVVVVVVVVVVVVVVVVVVVVVVVVVVVVVVVVVVVV%
%\VVVVVVVVVVVVVVVVVVVVVVVVVVVVVVVVVVVVV%
%/VVVVVVVVVVVVVVVVVVVVVVVVVVVVVVVVVVVVV%
%%%%%%%%%%%%%%%%%%%%%%%%%%%%%%%%%%%%%%%%
