0000000000000000000000000000000000000000
0000000000000000000000000000000000000000
0000000000000000000000000000000000000000
0000000000000000000000000000000000000000
0000000000000000000000000000000000000000
0000000000000000000000000000000000000000
0000000000000000000000000000000000000000
0000000000000000000000000000000000000000
0000000000000000000000011A11000000000000
0000000000000000000000/*****\00000000000
0000000000000000000001*******11111111111
0000000000000000000001v****************1
0000000000000000000001*******111111111*1
0000000000000000000000\*****/--------1*1
0000000000000000000000011A110--------1*1
00000000000000000000000000000--------1*1
00000000000000000000000000000--------1*1
11111111111111111111111111111111111111*1
19===================================1*1
1=111111111111111111111111111113111111*1
1=1----------------------------********1
1=1----------------------------********1
1=1-1RRRRRRRRRRRRRRRRRRRRRRRRRRRRRRRRRRR
1=1-1TAAAAAAAAAAAAAAAAAA-1-R000000000000
1=1-1T111111111111111111-1-R000000000000
1=1-1T1=====6====1=====1-4-R000000000000
1=1-1T#================1-y-R000000000000
1=1-1=#================111-R000000000000
1=1-1=1OOOO88OOOO1=======1-R000000000000
1=1-1=1OKKK88KKKO1=======1=R000000000000
1=1-1=1OOOO88OOOO1=======#=R000000000000
1=1-1=1OKKK88KKKO1======1RRR000000000000
1=1-1=1OOOO88OOOO1===6==1000000000000000
1=1-1=1OKKK88KKKO1======1000000000000000
1=1-1-1OOOO88OOOO1======9000000000000000
1=1-1-1OKKK88KKKO11111111001000000000000
1=I---IOOOO88OOOOI0000000001000000000000
1=I---IOKKK88KKKOI0000000001000000000000
1=I---IOOOO88OOOOI0000000001000000000000
1#I00II1111~~1111I00I1111111000000000000
