VVVVVVVVVVVVVVVVVVVVVVVVVVVVVVVVVVVVVVVV
VVVVVVVVVVVVVVVVVVVVVVVVVVVVVVVVVVVVVVVV
VVVVVVVVVVVVVVVVVVVVVVVVVVVVVVVVVVVVVVVV
VVVVVVVVVVVVVVVVVVVVVVVVVVVVVVVVVVVVVVVV
VVVVVVVVVVVVVVVVVVVVVVVVVVVVVVVVVVVVVVVV
VVVVVVVVVVVVVVVVVVVVVVVVVVVVVVVVVVVVVVVV
VVVVVVVVVVVVVVVVVVVVVVVIIAIIVVVVVVVVVVVV
VVVVVVVVVVVVVVVVVVVVVV/*****\VVVVVVVVVVV
VVVVVVVVVVVVVVVVVVVVVI*******IIIIIIIIIII
VVVVVVVVVVVVVVVVVVVVVIv******!*********I
VVVVVVVVVVVVVVVVVVVVVI*******IIIIIIIII*I
VVVVVVVVVVVVVVVVVVVVVV\*****/VVVVVVVVI*I
VVVVVVVVVVVVVVVVVVVVVVVIIAIIVVVVVVVVVI*I
VVVVVVVVVVVVVVVVVVVVVVVVVVVVVVVVVVVVVI*I
VVVVVVVVVVVVVVVVVVVVVVVVVVVVVVVVVVVVVI*I
IIIIIIIIIIIIIIIIIIIIIIIIIIIIIIIIIIIIII*I
1====================================I*I
1=111111111111111111111131111111111111!I
1=1====================================I
1=1====================================I
1=1=1RRRRRRRRRRRRRRRRRRRRRRRRRRRRRRRRRRR
1=1=1TAAAAAAAAAAAAAAAAAA===11111DDDDRDDD
1=1=1RR11111111111111111==4#DDD1DDDDRDDD
1=1=1=R-=========1OOOOO1===111D1DDDDRDDD
1=1=1-#6-=======-~OOOOO1===1D1D1DDDDRDDD
1=1=1-#O---------~OOOOO111=1DRRRRRRRRDDD
1=1=1=1OOOO88OOOO1OOOOOOO1=1DRDDDDDDDDDD
1=1=1=1OKKK88KKKO1OOOOOOO1=1DRDDDDDDDDDD
1=1=1=1OOOO88OOOO1OOOOOO6#=1DRDDDDDDDDDD
1=1=1=1OKKK88KKKO1OOOOOOORRRRRD1OOO1DDDD
1=1=1=1OOOO88OOOO1OOOOOOO1DDDD_~OOO1DDDD
1=1=1=1OKKK88KKKO1OOOOOOO1=DDD_1OOO1DDDD
1=1=1=1OOOO88OOOO1OOOOOOO#=DDD_1DDDDDDDD
1=1=1=1OKKK88KKKO111111111=DDD_1DDDDDDDD
1=I===IOOOO886OOOIDDDDDDDDDDDD_1DDDDDDDD
1=I===IOKKK88KKKOIDDDDDDDDDDDD_1DDDDDDDD
19I===IOOOO88OOOOIDDDDDDDDDDDD_1DDDDDDDD
1~IIIII1111##1111IDDI1111111DDDDDDDDDDDD
IVVVVVVVVVVVVVVVVVVVVVVVVVVVVVVVVVVVVVVV
IVVVVVVVVVVVVVVVVVVVVVVVVVVVVVVVVVVVVVVV
