1111111111111111111111111111111111111111
1=======================================
1=11111111111111111111111111111111111111
1=1-----------------------------------#1
1=1-111111111111111111111111111111111111
1=1-1=AAAAAAAAAAAAAAAAAA-1-1000000000000
1=1-1=111111111111111111-1-1000000000000
1=1-1=1==========1=====1---1000000000000
1=1-1=#================1---1000000000000
1=1-1=#================111-1000000000000
1=1-1=1****88****1=======1-1000000000000
1=1-1=1*KKK88KKK*1=======1=1000000000000
1=1-1=1****88****1=========1000000000000
1=1-1=1*KKK88KKK*1======1111000000000000
1=1-1=1****88****1======1000000000000000
1=1-1=1*KKK88KKK*1======1000000000000000
1=1-1-1****88****1======#000000000000000
1=1-1-1*KKK88KKK*11111111001000000000000
1=I---I*yv*88****I0000000001000000000000
1=I---I*KKK88KKK*I0000000001000000000000
1=I---I****88****I0000000001000000000000
1#I00II1111~~1111I00I1111111000000000000
1__\/____(1~~1)___\/_1------000000000000
1_____00_____________1------000000000000
1_4000000______00000_1------000000000000
1_000000000000000000_I111111111000000000
1_000000000000000000_I0001#1001000000000
1_000000000000000000_I010101001000000000
1_000000000000000000_I010101=0A000000000
1_00000000____000000_I010101=01000000000
1_00000000_}{_000000_I010101=01000000000
1_00000000_{}_000000_I0101#1=01000000000
1_00000000____000000_I#111===01000000000
#_000000000000000000_I1111#1111000000000
#_00000000000e000000_1---------000000000
1____________________1---------000000000
1111111111111111111111111111111111111111
0000000000000000000000000000000000000000
0000000000000000000000000000000000000000
0000000000000000000000000000000000000000
